1,1,1,1,1,1,1,1,1,1,1,1,1,1,1,1,1,1,1,1,1,1,1,1,1
1,1,1,1,1,1,1,1,1,1,1,1,1,1,1,1,1,1,2,5,1,1,1,1,1
1,1,1,7,1,3,1,1,1,1,0,0,0,0,0,1,0,0,0,0,0,1,0,1,1
1,1,0,0,0,0,0,0,0,1,3,1,0,0,0,3,0,0,0,0,0,2,0,1,1
1,2,0,0,0,0,0,0,0,0,0,6,6,4,6,6,0,0,0,0,0,4,0,1,1
1,1,0,0,0,0,0,0,0,0,0,0,0,0,0,0,0,0,0,0,0,8,0,1,1
1,1,0,0,0,0,0,0,0,0,0,0,0,0,0,0,0,0,0,0,0,9,0,1,1
1,1,0,0,0,0,0,0,0,0,0,6,6,4,6,6,0,0,0,0,0,4,0,1,1
1,1,0,0,0,0,0,0,0,2,1,1,0,0,0,1,0,0,0,0,0,1,0,1,1
1,1,1,2,1,1,7,7,1,1,1,0,0,0,0,1,0,0,0,0,0,1,0,1,1
1,1,1,1,1,1,1,1,1,1,1,1,1,1,1,1,1,1,1,5,3,1,1,1,1
1,1,1,1,1,1,1,1,1,1,1,1,1,1,1,1,1,1,1,1,1,1,1,1,1
